⚠ THIS RESOURCE PACK WILL NOT WORK WITHOUT THE CORRESPONDING DATA PACK ⚠

All music was made by glass beach.
Data pack programming and resource pack art was made by me, Sydney Cunningham/Cygnus.

This data pack/resource pack adds glass beach's music to the game as music discs, which can be obtained in the following ways:

Any song from "the first glass beach album": Dropped by a zombie that was killed by a skeleton
Any song from "plastic death": Dropped by a drowned that was killed by a skeleton
Beach Life In Death: Found in dungeon chests
welcome to the black parade: Found in dungeon chests

All of the songs from the first glass beach album and plastic death can also be found in the following loot chests:

- classic j dies and goes to hell part 1: village snowy house
- bedroom community: woodland mansion
- (forever?????????): igloo chest
- bone skull: bastion treasure
- neon glow: end city treasure
- cold weather: ancient city ice box
- calico: village plains house
- glass beach: buried treasure
- (blood rivers): underwater ruin small
- dallas: woodland mansion
- (rat castle): jungle temple
- planetarium: stronghold corridor
- soft!!!!!!: stronghold library
- yoshi's island: village taiga house
- orchids: ancient city

- coelacanth: shipwreck supply
- motions: trial chambers corridor
- slip under the door: pillager outpost
- guitar song: village savanna house
- rare animal: shipwreck treasure
- cul-de-sac: trial chambers entrance
- whalefall: underwater ruin big
- puppy: village desert house
- the killer: abandoned mineshaft
- the CIA: shipwreck map
- 200: desert temple
- commatose: shipwreck treasure
- abyss angel: stronghold library

If you have any feedback or bug reports, send them to me on Discord (@cygd)